字表	主題	詞性	中文
animal	Animals & insects (動物/昆蟲)	n.	動物
bear	Animals & insects (動物/昆蟲)	n.	熊
bee	Animals & insects (動物/昆蟲)	n.	蜜蜂
bird	Animals & insects (動物/昆蟲)	n.	鳥
bite	Animals & insects (動物/昆蟲)	v.	咬
butterfly	Animals & insects (動物/昆蟲)	n.	蝴蝶
cat	Animals & insects (動物/昆蟲)	n.	貓
chicken	Animals & insects (動物/昆蟲)	n.	雞
cow	Animals & insects (動物/昆蟲)	n.	乳牛
dog	Animals & insects (動物/昆蟲)	n.	狗
duck	Animals & insects (動物/昆蟲)	n.	鴨子
elephant	Animals & insects (動物/昆蟲)	n.	大象
fish	Animals & insects (動物/昆蟲)	n.	魚
frog	Animals & insects (動物/昆蟲)	n.	青蛙
hippo	Animals & insects (動物/昆蟲)	n.	河馬
horse	Animals & insects (動物/昆蟲)	n.	馬
koala	Animals & insects (動物/昆蟲)	n.	無尾熊
lion	Animals & insects (動物/昆蟲)	n.	獅子
mice	Animals & insects (動物/昆蟲)	n.	老鼠(複數)
monkey	Animals & insects (動物/昆蟲)	n.	猴子
mouse	Animals & insects (動物/昆蟲)	n.	老鼠
panda	Animals & insects (動物/昆蟲)	n.	大貓熊
pet	Animals & insects (動物/昆蟲)	n.	寵物
pig	Animals & insects (動物/昆蟲)	n.	豬
rabbit	Animals & insects (動物/昆蟲)	n.	兔子
sheep	Animals & insects (動物/昆蟲)	n.	綿羊
snake	Animals & insects (動物/昆蟲)	n.	蛇
spider	Animals & insects (動物/昆蟲)	n.	蜘蛛
tiger	Animals & insects (動物/昆蟲)	n.	老虎
turtle	Animals & insects (動物/昆蟲)	n.	烏龜
whale	Animals & insects (動物/昆蟲)	n.	鯨魚
zebra	Animals & insects (動物/昆蟲)	n.	斑馬
a	Articles & determiners (冠詞/限定詞)	art.	一個
an	Articles & determiners (冠詞/限定詞)	art.	一個
every	Articles & determiners (冠詞/限定詞)	det.	每一個
her	Articles & determiners (冠詞/限定詞)	det.	她的
his	Articles & determiners (冠詞/限定詞)	det.	他的
its	Articles & determiners (冠詞/限定詞)	det.	它的、牠的
my	Articles & determiners (冠詞/限定詞)	det.	我的
our	Articles & determiners (冠詞/限定詞)	det.	我們的
that	Articles & determiners (冠詞/限定詞)	det.	那個
the	Articles & determiners (冠詞/限定詞)	art.	這
their	Articles & determiners (冠詞/限定詞)	det.	他們的
these	Articles & determiners (冠詞/限定詞)	det.	這些
this	Articles & determiners (冠詞/限定詞)	det.	這個
those	Articles & determiners (冠詞/限定詞)	det.	那些
your	Articles & determiners (冠詞/限定詞)	det.	你的、你們的
can	Be & auxiliarie (be動詞/助動詞)	aux.	可以
be	Be & auxiliarie (be動詞/助動詞)	aux.	是(is, am, are)
do	Be & auxiliarie (be動詞/助動詞)	aux	助動詞
have	Be & auxiliarie (be動詞/助動詞)	aux.	助動詞
will	Be & auxiliarie (be動詞/助動詞)	aux.	將會
bag	Clothing & accessories (衣服/配件)	n.	袋子
cap	Clothing & accessories (衣服/配件)	n.	棒球帽
clothes	Clothing & accessories (衣服/配件)	n.	衣服
coat	Clothing & accessories (衣服/配件)	n.	外套
dress	Clothing & accessories (衣服/配件)	n.	洋裝
glasses	Clothing & accessories (衣服/配件)	n.	眼鏡
hat	Clothing & accessories (衣服/配件)	n.	帽子
jacket	Clothing & accessories (衣服/配件)	n.	夾克外套
pants	Clothing & accessories (衣服/配件)	n.	長褲
pocket	Clothing & accessories (衣服/配件)	n.	口袋
shirt	Clothing & accessories (衣服/配件)	n.	襯衫
shoes	Clothing & accessories (衣服/配件)	n.	鞋子
shorts	Clothing & accessories (衣服/配件)	n.	短褲
skirt	Clothing & accessories (衣服/配件)	n.	裙子
socks	Clothing & accessories (衣服/配件)	n.	襪子
sweater	Clothing & accessories (衣服/配件)	n.	毛衣
T-shirt	Clothing & accessories (衣服/配件)	n.	T 恤
umbrella	Clothing & accessories (衣服/配件)	n.	傘
wear	Clothing & accessories (衣服/配件)	v.	穿、戴
black	Colors (顏色)	adj.	黑色的
blue	Colors (顏色)	adj.	藍色的
brown	Colors (顏色)	adj.	咖啡色的
color	Colors (顏色)	n.	顏色
gray	Colors (顏色)	adj.	灰色的
green	Colors (顏色)	adj.	綠色的
orange	Colors (顏色)	adj.	橘色的
pink	Colors (顏色)	adj.	粉紅色的
purple	Colors (顏色)	adj.	紫色的
red	Colors (顏色)	adj.	紅色的
white	Colors (顏色)	adj.	白色的
yellow	Colors (顏色)	adj.	黃色的
and	Conjunctions (連接詞)	conj.	和
because	Conjunctions (連接詞)	conj.	因為
but	Conjunctions (連接詞)	conj.	但是
aunt	Family (家庭)	n.	阿姨、姑姑
brother	Family (家庭)	n.	哥哥、弟弟
cousin	Family (家庭)	n.	堂兄弟姊妹
dad	Family (家庭)	n.	爸爸
daddy	Family (家庭)	n.	爸爸
daughter	Family (家庭)	n.	女兒
family	Family (家庭)	n.	家庭、家人
father	Family (家庭)	n.	爸爸
grandfather	Family (家庭)	n.	外公、爺爺
grandma	Family (家庭)	n.	外婆、奶奶
grandmother	Family (家庭)	n.	外婆、奶奶
grandpa	Family (家庭)	n.	外公、爺爺
grow	Family (家庭)	v.	成長、長大
live	Family (家庭)	v.	住
mom	Family (家庭)	n.	媽媽
mommy	Family (家庭)	n.	媽媽
mother	Family (家庭)	n.	媽媽
parent	Family (家庭)	n.	父母親
sister	Family (家庭)	n.	姐姐、妹妹
son	Family (家庭)	n.	兒子
uncle	Family (家庭)	n.	叔叔、舅舅
apple	Food & drink (食物/飲料)	n.	蘋果
banana	Food & drink (食物/飲料)	n.	香蕉
beef	Food & drink (食物/飲料)	n.	牛肉
bread	Food & drink (食物/飲料)	n.	麵包
breakfast	Food & drink (食物/飲料)	n.	早餐
cake	Food & drink (食物/飲料)	n.	蛋糕
candy	Food & drink (食物/飲料)	n.	糖果
chicken	Food & drink (食物/飲料)	n.	雞肉
chocolate	Food & drink (食物/飲料)	n.	巧克力
coffee	Food & drink (食物/飲料)	n.	咖啡
cola/coke	Food & drink (食物/飲料)	n.	可樂
cook	Food & drink (食物/飲料)	n.	廚師
cookies	Food & drink (食物/飲料)	n.	餅乾
dinner	Food & drink (食物/飲料)	n.	晚餐
drink	Food & drink (食物/飲料)	v.	喝
duck	Food & drink (食物/飲料)	n.	鴨肉
dumpling	Food & drink (食物/飲料)	n.	水餃
eat	Food & drink (食物/飲料)	v.	吃
egg	Food & drink (食物/飲料)	n.	蛋
fish	Food & drink (食物/飲料)	n.	魚肉
food	Food & drink (食物/飲料)	n.	食物
French fries	Food & drink (食物/飲料)	n.	薯條
fruit	Food & drink (食物/飲料)	n.	水果
full	Food & drink (食物/飲料)	adj.	飽的
grape	Food & drink (食物/飲料)	n.	葡萄
hamburger	Food & drink (食物/飲料)	n.	漢堡
hungry	Food & drink (食物/飲料)	adj.	餓的
ice cream	Food & drink (食物/飲料)	n.	冰淇淋
juice	Food & drink (食物/飲料)	n.	果汁
lemon	Food & drink (食物/飲料)	n.	檸檬
lunch	Food & drink (食物/飲料)	n.	午餐
meal	Food & drink (食物/飲料)	n.	餐
milk	Food & drink (食物/飲料)	n.	牛奶
noodles	Food & drink (食物/飲料)	n.	麵
orange	Food & drink (食物/飲料)	n.	橘子
peach	Food & drink (食物/飲料)	n.	桃子
pie	Food & drink (食物/飲料)	n.	派
pizza	Food & drink (食物/飲料)	n.	披薩
pork	Food & drink (食物/飲料)	n.	豬肉
pumpkin	Food & drink (食物/飲料)	n.	南瓜
rice	Food & drink (食物/飲料)	n.	米飯
salad	Food & drink (食物/飲料)	n.	沙拉
sandwich	Food & drink (食物/飲料)	n.	三明治
soup	Food & drink (食物/飲料)	n.	湯
strawberry	Food & drink (食物/飲料)	n.	草莓
sweet	Food & drink (食物/飲料)	adj.	甜的
taste	Food & drink (食物/飲料)	v.	嚐起來
tea	Food & drink (食物/飲料)	n.	茶
thirsty	Food & drink (食物/飲料)	adj.	口渴的
water	Food & drink (食物/飲料)	n.	水
watermelon	Food & drink (食物/飲料)	n.	西瓜
yummy	Food & drink (食物/飲料)	adj.	美味的
Miss	Forms of address (稱謂)	--	小姐
Mr.	Forms of address (稱謂)	--	先生
Mrs.	Forms of address (稱謂)	--	太太
name	Forms of address (稱謂)	n.	名字
beach	Geographical terms (地理名詞)	n.	海灘
lake	Geographical terms (地理名詞)	n.	湖
mountain	Geographical terms (地理名詞)	n.	山
river	Geographical terms (地理名詞)	n.	河流
sea	Geographical terms (地理名詞)	n.	大海
cold	Health (健康)	n.	感冒
headache	Health (健康)	n.	頭痛
sick	Health (健康)	adj.	生病的
strong	Health (健康)	adj.	強壯的
tired	Health (健康)	adj.	疲累的
toothache	Health (健康)	n.	牙痛
well	Health (健康)	adj./adv.	好的；健康地
Christmas	Holidays & festivals	n.	聖誕節
Dragon Boat Festival	Holidays & festivals	n.	端午節
Easter	Holidays & festivals	n.	復活節
Halloween	Holidays & festivals	n.	萬聖節
Moon Festival	Holidays & festivals	n.	中秋節
bathroom	Houses & apartments (房子/公寓)	n.	浴室
bed	Houses & apartments (房子/公寓)	n.	床
bedroom	Houses & apartments (房子/公寓)	n.	臥房
chair	Houses & apartments (房子/公寓)	n.	椅子
clean	Houses & apartments (房子/公寓)	adj.	乾淨的
clean	Houses & apartments (房子/公寓)	v.	清理
computer	Houses & apartments (房子/公寓)	n.	電腦
desk	Houses & apartments (房子/公寓)	n.	桌子
dining room	Houses & apartments (房子/公寓)	n.	(家裡的)餐廳
door	Houses & apartments (房子/公寓)	n.	門
fan	Houses & apartments (房子/公寓)	n.	電扇
floor	Houses & apartments (房子/公寓)	n.	地板
fridge	Houses & apartments (房子/公寓)	n.	電冰箱
garden	Houses & apartments (房子/公寓)	n.	院子、花園
home	Houses & apartments (房子/公寓)	n.	家庭
house	Houses & apartments (房子/公寓)	n.	房子
key	Houses & apartments (房子/公寓)	n.	鑰匙
kitchen	Houses & apartments (房子/公寓)	n.	廚房
lamp	Houses & apartments (房子/公寓)	n.	燈
living room	Houses & apartments (房子/公寓)	n.	客廳
mop	Houses & apartments (房子/公寓)	v.	用拖把拖地
refrigerator	Houses & apartments (房子/公寓)	n.	電冰箱
shelf	Houses & apartments (房子/公寓)	n.	架子
shower	Houses & apartments (房子/公寓)	n.	淋浴
sofa	Houses & apartments (房子/公寓)	n.	沙發
street	Houses & apartments (房子/公寓)	n.	街道
sweep	Houses & apartments (房子/公寓)	v.	掃
table	Houses & apartments (房子/公寓)	n.	桌子
telephone	Houses & apartments (房子/公寓)	n.	電話
television	Houses & apartments (房子/公寓)	n.	電視
towel	Houses & apartments (房子/公寓)	n.	毛巾
TV	Houses & apartments (房子/公寓)	n.	電視
wall	Houses & apartments (房子/公寓)	n.	牆壁
wash	Houses & apartments (房子/公寓)	v.	洗
window	Houses & apartments (房子/公寓)	n.	窗戶
bye	Interjections (感嘆詞)	interj.	再見
excuse me	Interjections (感嘆詞)	interj.	不好意思
goodbye	Interjections (感嘆詞)	interj.	再見
hello	Interjections (感嘆詞)	interj.	哈囉、嗨
hi	Interjections (感嘆詞)	interj.	哈囉、嗨
please	Interjections (感嘆詞)	interj.	請
buy	Money (金錢)	v.	買
dollar	Money (金錢)	n.	元
free	Money (金錢)	adj.	免費的
money	Money (金錢)	n.	錢
all	Numbers (數字)	det.	全部的
both	Numbers (數字)	det.	兩個都
eight	Numbers (數字)	number	八
eighteen	Numbers (數字)	number	十八
eighty	Numbers (數字)	number	八十
eleven	Numbers (數字)	number	十一
fifteen	Numbers (數字)	number	十五
fifty	Numbers (數字)	number	五十
first	Numbers (數字)	number	第一
five	Numbers (數字)	number	五
forty	Numbers (數字)	number	四十
four	Numbers (數字)	number	四
fourteen	Numbers (數字)	number	十四
hundred	Numbers (數字)	number	一百
last	Numbers (數字)	det./adj.	最後的
many	Numbers (數字)	det./adj.	許多
more	Numbers (數字)	det./adv.	較多
much	Numbers (數字)	det./adv.	許多
nine	Numbers (數字)	number	九
nineteen	Numbers (數字)	number	十九
ninety	Numbers (數字)	number	九十
number	Numbers (數字)	n.	數字
one	Numbers (數字)	number	一
second	Numbers (數字)	number	第二
seven	Numbers (數字)	number	七
seventeen	Numbers (數字)	number	十七
seventy	Numbers (數字)	number	七十
six	Numbers (數字)	number	六
sixteen	Numbers (數字)	number	十六
sixty	Numbers (數字)	number	六十
some	Numbers (數字)	det.	一些
ten	Numbers (數字)	number	十
third	Numbers (數字)	number	第三
thirteen	Numbers (數字)	number	十三
thirty	Numbers (數字)	number	三十
three	Numbers (數字)	number	三
twelve	Numbers (數字)	number	十二
twenty	Numbers (數字)	number	二十
two	Numbers (數字)	number	二
zero	Numbers (數字)	number	零
actor	Occupations (工作)	n.	男演員
actress	Occupations (工作)	n.	女演員
cook	Occupations (工作)	v.	做飯
doctor	Occupations (工作)	n.	醫生
driver	Occupations (工作)	n.	司機、駕駛員
farmer	Occupations (工作)	n.	農夫
job	Occupations (工作)	n.	工作、職業
mailman	Occupations (工作)	n.	郵差
nurse	Occupations (工作)	n.	護士
police officer	Occupations (工作)	n.	警察
singer	Occupations (工作)	n.	歌手
soldier	Occupations (工作)	n.	軍人
waiter	Occupations (工作)	n.	男服務生
waitress	Occupations (工作)	n.	女服務生
work	Occupations (工作)	n.	工作
worker	Occupations (工作)	n.	工作者
cool	Other adjectives (其他形容詞)	adj.	清涼的
different	Other adjectives (其他形容詞)	adj.	不一樣的
dirty	Other adjectives (其他形容詞)	adj.	髒的
easy	Other adjectives (其他形容詞)	adj.	簡單的
favorite	Other adjectives (其他形容詞)	adj.	最喜歡的
fine	Other adjectives (其他形容詞)	adj.	很不錯的
fun	Other adjectives (其他形容詞)	adj.	有趣的
great	Other adjectives (其他形容詞)	adj.	很棒的
hard	Other adjectives (其他形容詞)	adj.	困難的
hot	Other adjectives (其他形容詞)	adj.	燙的
interesting	Other adjectives (其他形容詞)	adj.	有趣的
new	Other adjectives (其他形容詞)	adj.	新的
OK	Other adjectives (其他形容詞)	adj.	好的
only	Other adjectives (其他形容詞)	adj.	僅有的
other	Other adjectives (其他形容詞)	det./pron./adj.	其他的
quiet	Other adjectives (其他形容詞)	adj.	安靜的
ready	Other adjectives (其他形容詞)	adj.	準備好的
right	Other adjectives (其他形容詞)	adj.	對的
sorry	Other adjectives (其他形容詞)	adj.	感到抱歉的
sure	Other adjectives (其他形容詞)	adj.	確定的
wet	Other adjectives (其他形容詞)	adj.	濕的
wonderful	Other adjectives (其他形容詞)	adj.	很棒的
again	Other adverbs (其他副詞)	adv.	再一次
always	Other adverbs (其他副詞)	adv.	總是、永遠
away	Other adverbs (其他副詞)	adv.	離開
maybe	Other adverbs (其他副詞)	adv.	也許
never	Other adverbs (其他副詞)	adv.	不曾
no	Other adverbs (其他副詞)	adv.	不
not	Other adverbs (其他副詞)	adv.	不、沒有
OK	Other adverbs (其他副詞)	adv.	沒事
only	Other adverbs (其他副詞)	adv.	唯一地
really	Other adverbs (其他副詞)	adv.	真正地
so	Other adverbs (其他副詞)	adv.	所以
sometimes	Other adverbs (其他副詞)	adv.	有時候
still	Other adverbs (其他副詞)	adv.	仍然
sure	Other adverbs (其他副詞)	adv.	當然
then	Other adverbs (其他副詞)	adv.	然後、接著
together	Other adverbs (其他副詞)	adv.	一起
too	Other adverbs (其他副詞)	adv.	也；太…
usually	Other adverbs (其他副詞)	adv.	通常
very	Other adverbs (其他副詞)	adv.	非常
yes	Other adverbs (其他副詞)	adv.	是
birthday	Other nouns (其他名詞)	n.	生日
bottle	Other nouns (其他名詞)	n.	瓶子
box	Other nouns (其他名詞)	n.	箱子
can	Other nouns (其他名詞)	n.	罐子
cellphone	Other nouns (其他名詞)	n.	手機
dream	Other nouns (其他名詞)	n.	夢
e-mail/email	Other nouns (其他名詞)	n.	電子郵件
flower	Other nouns (其他名詞)	n.	花
fun	Other nouns (其他名詞)	n.	樂趣
gift	Other nouns (其他名詞)	n.	禮物
mail	Other nouns (其他名詞)	n.	信
party	Other nouns (其他名詞)	n.	派對
photo	Other nouns (其他名詞)	n.	照片
robot	Other nouns (其他名詞)	n.	機器人
sale	Other nouns (其他名詞)	n.	拍賣、特價
thing	Other nouns (其他名詞)	n.	東西
ticket	Other nouns (其他名詞)	n.	票
trash	Other nouns (其他名詞)	n.	垃圾
tree	Other nouns (其他名詞)	n.	樹
way	Other nouns (其他名詞)	n.	路、方向
word	Other nouns (其他名詞)	n.	字
brush	Other verbs (其他動詞)	v.	用刷子刷
call	Other verbs (其他動詞)	v.	打電話給…
close	Other verbs (其他動詞)	v.	關
come	Other verbs (其他動詞)	v.	來
cry	Other verbs (其他動詞)	v.	哭泣
do	Other verbs (其他動詞)	v.	做
enjoy	Other verbs (其他動詞)	v.	享受
fall	Other verbs (其他動詞)	v.	掉落
feel	Other verbs (其他動詞)	v.	感覺
find	Other verbs (其他動詞)	v.	找
get	Other verbs (其他動詞)	v.	得到
give	Other verbs (其他動詞)	v.	給
go	Other verbs (其他動詞)	v.	去、走
have	Other verbs (其他動詞)	v.	有
help	Other verbs (其他動詞)	v.	幫助
hit	Other verbs (其他動詞)	v.	打、碰撞
hope	Other verbs (其他動詞)	v.	希望
hurry	Other verbs (其他動詞)	v.	趕快、急忙
hurt	Other verbs (其他動詞)	v.	受傷
jump	Other verbs (其他動詞)	v.	跳
know	Other verbs (其他動詞)	v.	知道、認識
laugh	Other verbs (其他動詞)	v.	笑
let's	Other verbs (其他動詞)	v.	讓我們…
like	Other verbs (其他動詞)	v.	喜歡
look	Other verbs (其他動詞)	v.	看、看起來
love	Other verbs (其他動詞)	v.	(喜)愛
make	Other verbs (其他動詞)	v.	做、製造
meet	Other verbs (其他動詞)	v.	遇見、會面
miss	Other verbs (其他動詞)	v.	想念
need	Other verbs (其他動詞)	v.	需要
open	Other verbs (其他動詞)	v.	開
pick up	Other verbs (其他動詞)	v.	撿起、接(人、電話)
put	Other verbs (其他動詞)	v.	放
see	Other verbs (其他動詞)	v.	看見
show	Other verbs (其他動詞)	v.	給...看、展示
sit	Other verbs (其他動詞)	v.	坐下
sleep	Other verbs (其他動詞)	v.	睡覺
smell	Other verbs (其他動詞)	v.	聞起來
stand	Other verbs (其他動詞)	v.	站、站立
start	Other verbs (其他動詞)	v.	開始
stop	Other verbs (其他動詞)	v.	停下來
take	Other verbs (其他動詞)	v.	攜帶、拿取
tell	Other verbs (其他動詞)	v.	告訴
thank	Other verbs (其他動詞)	v.	感謝(某人)
touch	Other verbs (其他動詞)	v.	觸碰
try	Other verbs (其他動詞)	v.	嘗試
wait	Other verbs (其他動詞)	v.	等待
wake	Other verbs (其他動詞)	v.	醒來、喚醒
walk	Other verbs (其他動詞)	v.	走路
want	Other verbs (其他動詞)	v.	想要
watch	Other verbs (其他動詞)	v.	看
welcome	Other verbs (其他動詞)	v.	歡迎
worry	Other verbs (其他動詞)	v.	擔心
arm	Parts of body (身體部位)	n.	手臂
back	Parts of body (身體部位)	n.	背
ear	Parts of body (身體部位)	n.	耳朵
eye	Parts of body (身體部位)	n.	眼睛
face	Parts of body (身體部位)	n.	臉
feet	Parts of body (身體部位)	n.	腳（複數）
foot	Parts of body (身體部位)	n.	腳
hair	Parts of body (身體部位)	n.	頭髮
hand	Parts of body (身體部位)	n.	手
head	Parts of body (身體部位)	n.	頭
leg	Parts of body (身體部位)	n.	腿
mouth	Parts of body (身體部位)	n.	嘴巴
nose	Parts of body (身體部位)	n.	鼻子
teeth	Parts of body (身體部位)	n.	牙齒（複數）
tooth	Parts of body (身體部位)	n.	牙齒
baby	People (人)	n.	嬰兒
boy	People (人)	n.	男孩
girl	People (人)	n.	女孩
kid	People (人)	n.	小孩
man	People (人)	n.	男人
men	People (人)	n.	男人（複數）
people	People (人)	n.	人（複數）
person	People (人)	n.	人
woman	People (人)	n.	女人
women	People (人)	n.	女人（複數）
angry	Personal characteristics (個性/特點)	adj.	生氣的
bad	Personal characteristics (個性/特點)	adj.	壞的
beautiful	Personal characteristics (個性/特點)	adj.	美麗的
bored	Personal characteristics (個性/特點)	adj.	覺得無聊的
boring	Personal characteristics (個性/特點)	adj.	令人無聊的
busy	Personal characteristics (個性/特點)	adj.	忙碌的
cute	Personal characteristics (個性/特點)	adj.	可愛的
excited	Personal characteristics (個性/特點)	adj.	覺得興奮的
exciting	Personal characteristics (個性/特點)	adj.	令人興奮的
good	Personal characteristics (個性/特點)	adj.	好的
happy	Personal characteristics (個性/特點)	adj.	開心的
heavy	Personal characteristics (個性/特點)	adj.	（人）重的
lazy	Personal characteristics (個性/特點)	adj.	懶惰的
mad	Personal characteristics (個性/特點)	adj.	生氣的
nice	Personal characteristics (個性/特點)	adj.	宜人的
old	Personal characteristics (個性/特點)	adj.	年齡；老的
pretty	Personal characteristics (個性/特點)	adj.	漂亮的
sad	Personal characteristics (個性/特點)	adj.	傷心的
short	Personal characteristics (個性/特點)	adj.	矮的
smart	Personal characteristics (個性/特點)	adj.	聰明的
tall	Personal characteristics (個性/特點)	adj.	高的
thin	Personal characteristics (個性/特點)	adj.	瘦的
young	Personal characteristics (個性/特點)	adj.	年輕的
back	Places & directions (地點/方位)	adv.	向後、回原處
bank	Places & directions (地點/方位)	n.	銀行
bookstore	Places & directions (地點/方位)	n.	書店
department store	Places & directions (地點/方位)	n.	百貨公司
fire station	Places & directions (地點/方位)	n.	消防站
here	Places & directions (地點/方位)	adv.	這裡
hospital	Places & directions (地點/方位)	n.	醫院
Japan	Places & directions (地點/方位)	n.	日本
left	Places & directions (地點/方位)	adj./adv.	左邊(的)
market	Places & directions (地點/方位)	n.	市場
movie theater	Places & directions (地點/方位)	n.	電影院
museum	Places & directions (地點/方位)	n.	博物館
office	Places & directions (地點/方位)	n.	辦公室
park	Places & directions (地點/方位)	n.	公園
police station	Places & directions (地點/方位)	n.	警察局
post office	Places & directions (地點/方位)	n.	郵局
restaurant	Places & directions (地點/方位)	n.	餐廳
restroom	Places & directions (地點/方位)	n.	洗手間、廁所
right	Places & directions (地點/方位)	adj.	右邊
shop	Places & directions (地點/方位)	n.	商店(英式英語)
store	Places & directions (地點/方位)	n.	商店(美式英語)
supermarket	Places & directions (地點/方位)	n.	超級市場
Taiwan	Places & directions (地點/方位)	n.	臺灣
there	Places & directions (地點/方位)	adv.	那裡
UK	Places & directions (地點/方位)	n.	英國
USA	Places & directions (地點/方位)	n.	美國
zoo	Places & directions (地點/方位)	n.	動物園
about	Prepositions (介系詞)	prep.	大約；關於
after	Prepositions (介系詞)	prep.	在…之後
at	Prepositions (介系詞)	prep.	在(某處、時刻)
before	Prepositions (介系詞)	prep./conj.	在…之前
behind	Prepositions (介系詞)	prep.	在…後面
by	Prepositions (介系詞)	prep.	在…旁邊
for	Prepositions (介系詞)	prep.	給、為了
from	Prepositions (介系詞)	prep.	從…
in	Prepositions (介系詞)	prep.	在…裡面、在某短時間裡
in front of	Prepositions (介系詞)	prep.	在…前面
inside	Prepositions (介系詞)	prep.	在…裡面、向…裡面
near	Prepositions (介系詞)	prep.	靠近、接近
next to	Prepositions (介系詞)	prep.	在…旁邊
of	Prepositions (介系詞)	prep.	…的
off	Prepositions (介系詞)	prep.	離開、從…去掉
on	Prepositions (介系詞)	prep.	在…上面；在(某一天)
out	Prepositions (介系詞)	prep.	向外地
outside	Prepositions (介系詞)	prep.	在…外面、向…外面
over	Prepositions (介系詞)	prep.	在…上方
than	Prepositions (介系詞)	prep.	比
to	Prepositions (介系詞)	prep.	向、朝、對著
under	Prepositions (介系詞)	prep.	在…下方
up	Prepositions (介系詞)	prep.	向上
with	Prepositions (介系詞)	prep.	和…一起
he	Pronouns (代名詞)	pron.	他
him	Pronouns (代名詞)	pron.	他(受詞)
I	Pronouns (代名詞)	pron.	我
it	Pronouns (代名詞)	pron.	它、牠
me	Pronouns (代名詞)	pron.	我(受詞)
nothing	Pronouns (代名詞)	pron.	什麼都沒有
she	Pronouns (代名詞)	pron.	她
them	Pronouns (代名詞)	pron.	他們(受詞)
they	Pronouns (代名詞)	pron.	他們
us	Pronouns (代名詞)	pron.	我們(受詞)
we	Pronouns (代名詞)	pron.	我們
you	Pronouns (代名詞)	pron.	你；你們
answer	School (學校)	v.	回答
art	School (學校)	n.	美術、藝術
ask	School (學校)	v.	問
blackboard	School (學校)	n.	黑板
book	School (學校)	n.	書、書本
Chinese	School (學校)	n.	中文
class	School (學校)	n.	課；班級
classroom	School (學校)	n.	教室
draw	School (學校)	v.	畫、描畫
English	School (學校)	n.	英文
eraser	School (學校)	n.	橡皮擦
friend	School (學校)	n.	朋友
glue	School (學校)	n.	膠水
homework	School (學校)	n.	回家作業
library	School (學校)	n.	圖書館
listen	School (學校)	v.	聽
marker	School (學校)	n.	麥克筆
math	School (學校)	n.	數學
music	School (學校)	n.	音樂
paper	School (學校)	n.	紙張
PE	School (學校)	n.	體育(課)
pen	School (學校)	n.	筆、鋼筆
pencil	School (學校)	n.	鉛筆
picture	School (學校)	n.	圖片、照片
question	School (學校)	n.	問題
read	School (學校)	v.	閱讀
ruler	School (學校)	n.	尺
say	School (學校)	v.	說
school	School (學校)	n.	學校
science	School (學校)	n.	科學
speak	School (學校)	v.	說
spell	School (學校)	v.	拼寫
story	School (學校)	n.	故事
student	School (學校)	n.	學生
study	School (學校)	v.	學習
talk	School (學校)	v.	說話、談話
teacher	School (學校)	n.	老師
test	School (學校)	n.	考試
vacation	School (學校)	n.	假期
write	School (學校)	v.	寫
big	Sizes & measurements (尺寸/計量)	adj.	大的
heavy	Sizes & measurements (尺寸/計量)	adj.	(物品)重的
high	Sizes & measurements (尺寸/計量)	adj.	高的
light	Sizes & measurements (尺寸/計量)	adj.	輕的
long	Sizes & measurements (尺寸/計量)	adj.	長的
pair	Sizes & measurements (尺寸/計量)	n.	一雙、一對
short	Sizes & measurements (尺寸/計量)	adj.	短的
small	Sizes & measurements (尺寸/計量)	adj.	小的
ball	Sports, interest & hobbies (運動/興趣/嗜好)	n.	球
baseball	Sports, interest & hobbies (運動/興趣/嗜好)	n.	棒球
basketball	Sports, interest & hobbies (運動/興趣/嗜好)	n.	籃球
card	Sports, interest & hobbies (運動/興趣/嗜好)	n.	卡片
climb	Sports, interest & hobbies (運動/興趣/嗜好)	v.	爬、攀爬
dance	Sports, interest & hobbies (運動/興趣/嗜好)	v.	跳舞
doll	Sports, interest & hobbies (運動/興趣/嗜好)	n.	玩偶
drum	Sports, interest & hobbies (運動/興趣/嗜好)	n.	鼓
fish	Sports, interest & hobbies (運動/興趣/嗜好)	v.	釣魚
game	Sports, interest & hobbies (運動/興趣/嗜好)	n.	遊戲、比賽
hike	Sports, interest & hobbies (運動/興趣/嗜好)	v.	健行
kite	Sports, interest & hobbies (運動/興趣/嗜好)	n.	風箏
movie	Sports, interest & hobbies (運動/興趣/嗜好)	n.	電影
paint	Sports, interest & hobbies (運動/興趣/嗜好)	v.	用顏料畫、刷油漆
piano	Sports, interest & hobbies (運動/興趣/嗜好)	n.	鋼琴
play	Sports, interest & hobbies (運動/興趣/嗜好)	v.	玩
run	Sports, interest & hobbies (運動/興趣/嗜好)	v.	跑、跑步
sing	Sports, interest & hobbies (運動/興趣/嗜好)	v.	唱歌
soccer/football	Sports, interest & hobbies (運動/興趣/嗜好)	n.	足球
song	Sports, interest & hobbies (運動/興趣/嗜好)	n.	歌曲
sport	Sports, interest & hobbies (運動/興趣/嗜好)	n.	運動
swim	Sports, interest & hobbies (運動/興趣/嗜好)	v.	游泳
toy	Sports, interest & hobbies (運動/興趣/嗜好)	n.	玩具
trip	Sports, interest & hobbies (運動/興趣/嗜好)	n.	(短程)旅行
win	Sports, interest & hobbies (運動/興趣/嗜好)	v.	贏
yo-yo	Sports, interest & hobbies (運動/興趣/嗜好)	n.	溜溜球
chopsticks	Tableware (餐具)	n.	筷子
cup	Tableware (餐具)	n.	杯子
dish	Tableware (餐具)	n.	碟子、盤子
fork	Tableware (餐具)	n.	叉子
glass	Tableware (餐具)	n.	玻璃杯
knife	Tableware (餐具)	n.	刀子
spoon	Tableware (餐具)	n.	湯匙
afternoon	Time (時間)	n.	下午
April	Time (時間)	n.	四月
August	Time (時間)	n.	八月
clock	Time (時間)	n.	時鐘
day	Time (時間)	n.	天
December	Time (時間)	n.	十二月
early	Time (時間)	adj./adv.	早到(的)
evening	Time (時間)	n.	傍晚
fall	Time (時間)	n.	秋天
February	Time (時間)	n.	二月
Friday	Time (時間)	n.	星期五
January	Time (時間)	n.	一月
July	Time (時間)	n.	七月
June	Time (時間)	n.	六月
late	Time (時間)	adj./adv.	晚到(的)
March	Time (時間)	n.	三月
May	Time (時間)	n.	五月
Monday	Time (時間)	n.	星期一
month	Time (時間)	n.	月
morning	Time (時間)	n.	早上
night	Time (時間)	n.	晚上
November	Time (時間)	n.	十一月
now	Time (時間)	adv.	現在
o'clock	Time (時間)	adv.	…點鐘
October	Time (時間)	n.	十月
Saturday	Time (時間)	n.	星期六
season	Time (時間)	n.	季節
September	Time (時間)	n.	九月
spring	Time (時間)	n.	春天
summer	Time (時間)	n.	夏天
Sunday	Time (時間)	n.	星期日
Thursday	Time (時間)	n.	星期四
time	Time (時間)	n.	時間
today	Time (時間)	n.	今天
tomorrow	Time (時間)	n.	明天
Tuesday	Time (時間)	n.	星期二
watch	Time (時間)	n.	手錶
Wednesday	Time (時間)	n.	星期三
week	Time (時間)	n.	星期
winter	Time (時間)	n.	冬天
year	Time (時間)	n.	年
yesterday	Time (時間)	n.	昨天
airplane	Transportation (運輸)	n.	飛機
airport	Transportation (運輸)	n.	機場
bicycle	Transportation (運輸)	n.	腳踏車
bike	Transportation (運輸)	n.	腳踏車
boat	Transportation (運輸)	n.	船
bus	Transportation (運輸)	n.	公車
bus stop	Transportation (運輸)	n.	公車站
car	Transportation (運輸)	n.	車子
drive	Transportation (運輸)	v.	開車
fast	Transportation (運輸)	adj./adv.	快速的(地)
fly	Transportation (運輸)	v.	飛、飛行
motorcycle	Transportation (運輸)	n.	摩托車
MRT	Transportation (運輸)	n.	捷運
plane	Transportation (運輸)	n.	飛機
ride	Transportation (運輸)	v.	騎(機車、腳踏車等)
scooter	Transportation (運輸)	n.	小型摩托車
ship	Transportation (運輸)	n.	(大)船
slow	Transportation (運輸)	adj.	慢的
station	Transportation (運輸)	n.	車站
taxi	Transportation (運輸)	n.	計程車
train	Transportation (運輸)	n.	火車
truck	Transportation (運輸)	n.	卡車
turn	Transportation (運輸)	v.	轉彎
cloudy	Weather & nature (天氣/自然)	adj.	多雲的
cold	Weather & nature (天氣/自然)	adj.	寒冷的
cool	Weather & nature (天氣/自然)	adj.	涼爽的
hot	Weather & nature (天氣/自然)	adj.	熱的
moon	Weather & nature (天氣/自然)	n.	月亮
rain	Weather & nature (天氣/自然)	n.	雨水
rain	Weather & nature (天氣/自然)	v.	下雨
rainbow	Weather & nature (天氣/自然)	n.	彩虹
rainy	Weather & nature (天氣/自然)	adj.	下雨的
sky	Weather & nature (天氣/自然)	n.	天空
snow	Weather & nature (天氣/自然)	n.	雪
snow	Weather & nature (天氣/自然)	v.	下雪
star	Weather & nature (天氣/自然)	n.	星星
sun	Weather & nature (天氣/自然)	n.	太陽
sunny	Weather & nature (天氣/自然)	adj.	晴朗的
typhoon	Weather & nature (天氣/自然)	n.	颱風
warm	Weather & nature (天氣/自然)	adj.	溫暖的
weather	Weather & nature (天氣/自然)	n.	天氣
wet	Weather & nature (天氣/自然)	adj.	潮濕的
wind	Weather & nature (天氣/自然)	n.	風
windy	Weather & nature (天氣/自然)	adj.	風大的
how	Wh-words (疑問詞)	adv.	如何…
what	Wh-words (疑問詞)	pron.	什麼…
when	Wh-words (疑問詞)	adv.	何時…
where	Wh-words (疑問詞)	adv.	在哪裡…
which	Wh-words (疑問詞)	det.	哪一個…
who	Wh-words (疑問詞)	pron.	誰…
whose	Wh-words (疑問詞)	det.	誰的…
why	Wh-words (疑問詞)	adv.	為什麼…