abandon	v	8	abandon
abandonment	n	8	abandon
abnormal	j	2	normal
abnormally	b	2	normal
abstract	jnv	6	abstract
abstraction	n	6	abstract
abstractly	b	6	abstract
academia	n	5	academy
academic	jn	5	academy
academically	b	5	academy
academy	n	5	academy
access	nv	4	access
accessibility	n	4	access
accessible	j	4	access
accommodate	v	9	accommodate
accommodating	j	9	accommodate
accommodation	n	9	accommodate
accompaniment	n	8	accompany
accompany	v	8	accompany
accompanying	j	8	accompany
accumulate	v	8	accumulate
accumulation	n	8	accumulate
accuracy	n	6	accurate
accurate	j	6	accurate
accurately	b	6	accurate
achievable	j	2	achieve
achieve	v	2	achieve
achievement	n	2	achieve
acknowledge	v	6	acknowledge
acknowledgement	n	6	acknowledge
acquire	v	2	acquire
acquisition	n	2	acquire
adapt	v	7	adapt
adaptability	n	7	adapt
adaptable	j	7	adapt
adaptation	n	7	adapt
adaptive	j	7	adapt
adequacy	n	4	adequate
adequate	j	4	adequate
adequately	b	4	adequate
adjacent	j	10	adjacent
adjust	v	5	adjust
adjustment	n	5	adjust
administrate	v	2	administrate
administration	n	2	administrate
administrative	j	2	administrate
administratively	b	2	administrate
administrator	n	2	administrate
adult	jn	7	adult
adulthood	n	7	adult
advocacy	n	7	advocate
advocate	nv	7	advocate
affect	nv	2	affect
affected	j	2	affect
affecting	j	2	affect
affective	j	2	affect
affectively	b	2	affect
aggregate	nv	6	aggregate
aggregation	n	6	aggregate
aid	nv	7	aid
albeit	c	10	albeit
allocate	v	6	allocate
allocation	n	6	allocate
alter	v	5	alter
alterable	j	5	alter
alteration	n	5	alter
alternate	v	5	alter
alternative	jn	3	alternative
alternatively	b	3	alternative
ambiguity	n	8	ambiguous
ambiguous	j	8	ambiguous
amend	v	5	amend
amendment	n	5	amend
analogous	j	9	analogy
analogy	n	9	analogy
analysis	n	1	analyze
analyst	n	1	analyze
analytic	j	1	analyze
analytical	j	1	analyze
analytically	b	1	analyze
analyze	v	1	analyze
analyzer	n	1	analyze
annual	j	4	annual
annually	b	4	annual
anticipate	v	9	anticipate
anticipation	n	9	anticipate
apparent	j	4	apparent
apparently	b	4	apparent
append	v	8	append
appendix	n	8	append
appreciable	j	8	appreciate
appreciably	b	8	appreciate
appreciate	v	8	appreciate
appreciation	n	8	appreciate
approach	nv	1	approach
approachable	j	1	approach
appropriacy	n	2	appropriate
appropriate	j	2	appropriate
appropriately	b	2	appropriate
appropriateness	n	2	appropriate
approximate	jnv	4	approximate
approximately	b	4	approximate
approximation	n	4	approximate
arbitrarily	b	8	arbitrary
arbitrariness	n	8	arbitrary
arbitrary	j	8	arbitrary
area	n	1	area
aspect	n	2	aspect
assemble	v	10	assemble
assembly	n	10	assemble
assess	v	1	assess
assessable	j	1	assess
assessment	n	1	assess
assign	v	6	assign
assignment	n	6	assign
assist	v	2	assist
assistance	n	2	assist
assistant	n	2	assist
assisted	j	2	assist
assume	v	1	assume
assumed	j	1	assume
assuming	j	1	assume
assumption	n	1	assume
assurance	n	9	assure
assure	v	9	assure
assuredly	b	9	assure
attach	v	6	attach
attached	j	6	attach
attachment	n	6	attach
attain	v	9	attain
attainable	j	9	attain
attainment	n	9	attain
attitude	n	4	attitude
attributable	j	4	attribute
attribute	nv	4	attribute
attribution	n	4	attribute
author	nv	6	author
authoritative	j	1	authority
authorities	n	1	authority
authority	n	1	authority
authorship	n	6	author
automate	v	8	automate
automatic	j	8	automate
automatically	b	8	automate
automation	n	8	automate
availability	n	1	available
available	j	1	available
aware	j	5	aware
awareness	n	5	aware
behalf	n	9	behalf
beneficial	j	1	benefit
beneficiary	n	1	benefit
benefit	jn	1	benefit
bias	nv	8	bias
biased	j	8	bias
bond	nv	6	bond
bonded	j	6	bond
brevity	n	6	brief
brief	jnv	6	brief
briefly	b	6	brief
bulk	nv	9	bulk
bulky	j	9	bulk
capability	n	6	capable
capable	j	6	capable
capacity	n	5	capacity
categorization	n	2	category
categorize	v	2	category
category	n	2	category
cease	v	9	cease
ceaseless	j	9	cease
challenge	nv	5	challenge
challenger	n	5	challenge
challenging	j	5	challenge
channel	nv	7	channel
chapter	n	2	chapter
chart	nv	8	chart
chemical	jn	7	chemical
chemically	b	7	chemical
circumstance	n	3	circumstance
citation	n	6	cite
cite	v	6	cite
civil	j	4	civil
clarification	n	8	clarify
clarify	v	8	clarify
clarity	n	8	clarify
classic	jn	7	classic
classical	j	7	classic
clause	n	5	clause
co-operate	v	6	cooperate
co-operation	n	6	cooperate
co-operative	j	6	cooperate
co-operatively	b	6	cooperate
co-ordinate	nv	3	coordinate
co-ordinated	j	3	coordinate
co-ordination	n	3	coordinate
co-ordinator	n	3	coordinate
code	nv	4	code
coherence	n	9	coherent
coherent	j	9	coherent
coherently	b	9	coherent
coincide	v	9	coincide
coincidence	n	9	coincide
coincident	j	9	coincide
coincidental	j	9	coincide
collapse	nv	10	collapse
collapsible	j	10	collapse
colleague	n	10	colleague
commence	v	9	commence
commencement	n	9	commence
comment	nv	3	comment
commentary	n	3	comment
commentator	n	3	comment
commission	nv	2	commission
commissioner	n	2	commission
commit	v	4	commit
commitment	n	4	commit
committed	j	4	commit
commodity	n	8	commodity
communicable	j	4	communicate
communicate	v	4	communicate
communication	n	4	communicate
communicative	j	4	communicate
communicatively	b	4	communicate
community	n	2	community
compatibility	n	9	compatible
compatible	j	9	compatible
compensate	v	3	compensate
compensation	n	3	compensate
compensatory	j	3	compensate
compilation	n	10	compile
compile	v	10	compile
complement	nv	8	complement
complementary	j	8	complement
complex	jn	2	complex
complexity	n	2	complex
component	n	3	component
componentry	n	3	component
compound	jnv	5	compound
comprehensive	j	7	comprehensive
comprehensively	b	7	comprehensive
comprise	v	7	comprise
computable	j	2	compute
computation	n	2	compute
computational	j	2	compute
compute	v	2	compute
computer	n	2	compute
computing	n	2	compute
conceivable	j	10	conceive
conceivably	b	10	conceive
conceive	v	10	conceive
concentrate	nv	4	concentrate
concentration	n	4	concentrate
concept	n	1	concept
conception	n	1	concept
conceptual	j	1	concept
conceptualization	n	1	concept
conceptualize	v	1	concept
conceptually	b	1	concept
conclude	v	2	conclude
concluding	j	2	conclude
conclusion	n	2	conclude
conclusive	j	2	conclude
conclusively	b	2	conclude
concurrent	j	9	concurrent
concurrently	b	9	concurrent
conduct	nv	2	conduct
confer	v	4	confer
conference	n	4	confer
confine	v	9	confine
confined	j	9	confine
confirm	v	7	confirm
confirmation	n	7	confirm
conflict	nv	5	conflict
conflicting	j	5	conflict
conform	v	8	conform
conformability	n	8	conform
conformable	j	8	conform
conformance	n	8	conform
conformation	n	8	conform
conformist	n	8	conform
conformity	n	8	conform
consensus	n	3	consent
consent	nv	3	consent
consequence	n	2	consequent
consequent	j	2	consequent
consequently	b	2	consequent
considerable	j	3	considerable
considerably	b	3	considerable
consist	v	1	consist
consistency	n	1	consist
consistent	j	1	consist
consistently	b	1	consist
constancy	n	3	constant
constant	jn	3	constant
constantly	b	3	constant
constituency	v	1	constitute
constituent	n	1	constitute
constitute	v	1	constitute
constitution	n	1	constitute
constitutional	j	1	constitute
constitutionally	b	1	constitute
constitutive	j	1	constitute
constrain	v	3	constrain
constraint	n	3	constrain
construct	nv	2	construct
construction	n	2	construct
constructive	j	2	construct
consult	v	5	consult
consultancy	n	5	consult
consultant	n	5	consult
consultation	n	5	consult
consultative	j	5	consult
consume	v	2	consume
consumer	n	2	consume
consumption	n	2	consume
contact	nv	5	contact
contactable	j	5	contact
contemporary	j	8	contemporary
context	n	1	context
contextual	j	1	context
contextualize	v	1	context
contract	nv	1	contract
contractor	n	1	contract
contradict	v	8	contradict
contradiction	n	8	contradict
contradictory	j	8	contradict
contrarily	b	7	contrary
contrary	jn	7	contrary
contrast	nv	4	contrast
contrastive	j	4	contrast
contribute	v	3	contribute
contribution	n	3	contribute
contributor	n	3	contribute
controversial	j	9	controversy
controversially	b	9	controversy
controversy	n	9	controversy
convene	v	3	convene
convention	n	3	convene
conventional	j	3	convene
conventionally	b	3	convene
converse	jn	9	converse
conversely	b	9	converse
conversion	n	7	convert
convert	nv	7	convert
convertible	j	7	convert
convince	v	10	convince
convincingly	b	10	convince
cooperate	v	6	cooperate
cooperation	n	6	cooperate
cooperative	j	6	cooperate
cooperatively	b	6	cooperate
coordinate	nv	3	coordinate
coordination	n	3	coordinate
coordinator	n	3	coordinate
core	nv	3	core
corporate	j	3	corporate
corporation	n	3	corporate
correspond	v	3	correspond
correspondence	n	3	correspond
corresponding	j	3	correspond
correspondingly	b	3	correspond
couple	nv	7	couple
coupled	j	7	couple
create	v	1	create
creation	n	1	create
creative	j	1	create
creatively	b	1	create
creativity	n	1	create
creator	n	1	create
credit	nv	2	credit
creditor	n	2	credit
criterion	n	3	criteria
crucial	j	8	crucial
crucially	b	8	crucial
cultural	j	2	culture
culturally	b	2	culture
culture	n	2	culture
cultured	j	2	culture
currency	n	8	currency
cycle	nv	4	cycle
cyclic	j	4	cycle
cyclical	j	4	cycle
cycling	n	4	cycle
data	n	1	data
debatable	j	4	debate
debate	nv	4	debate
decade	n	7	decade
decline	nv	5	decline
deduce	v	3	deduce
deduction	n	3	deduce
definable	j	1	define
define	v	1	define
definite	j	7	definite
definitely	b	7	definite
definition	n	1	define
definitive	j	7	definite
demonstrable	j	3	demonstrate
demonstrably	b	3	demonstrate
demonstrate	v	3	demonstrate
demonstration	n	3	demonstrate
demonstrative	j	3	demonstrate
demonstratively	b	3	demonstrate
demonstrator	n	3	demonstrate
deniable	j	7	deny
denial	j	7	deny
denotation	n	8	denote
denote	v	8	denote
deny	v	7	deny
depress	v	10	depress
depression	n	10	depress
deregister	v	3	register
deregistration	n	3	register
deregulate	v	2	regulate
deregulation	n	2	regulate
derivation	n	1	derive
derivative	j	1	derive
derive	v	1	derive
derived	j	1	derive
design	nv	2	design
designer	n	2	design
despite	p	4	despite
detect	v	8	detect
detectable	j	8	detect
detection	n	8	detect
detective	n	8	detect
detector	n	8	detect
deviate	v	8	deviate
deviation	n	8	deviate
device	n	9	device
devote	v	9	devote
devoted	j	9	devote
devotedly	b	9	devote
devotion	n	9	devote
differentiate	v	7	differentiate
differentiation	n	7	differentiate
dimension	n	4	dimension
dimensional	j	4	dimension
diminish	v	9	diminish
diminution	n	9	diminish
discrete	j	5	discrete
discretely	b	5	discrete
discretion	n	5	discrete
discretionary	n	5	discrete
discriminate	jv	6	discriminate
discriminating	j	6	discriminate
discrimination	n	6	discriminate
disestablish	v	1	establish
disestablishment	n	1	establish
displace	v	8	displace
displacement	n	8	displace
display	nv	6	display
disposable	j	7	dispose
disposal	n	7	dispose
dispose	v	7	dispose
disproportion	n	3	proportion
disproportionate	j	3	proportion
disproportionately	b	3	proportion
dissimilar	j	1	similar
distinct	j	2	distinct
distinction	n	2	distinct
distinctive	j	2	distinct
distinctively	b	2	distinct
distinctly	b	2	distinct
distort	v	9	distort
distortion	n	9	distort
distribute	v	1	distribute
distributed	j	1	distribute
distribution	n	1	distribute
distributional	j	1	distribute
distributive	j	1	distribute
distributor	n	1	distribute
diverse	j	6	diverse
diversely	b	6	diverse
diversification	n	6	diverse
diversify	v	6	diverse
diversity	n	6	diverse
document	nv	3	document
documentation	n	3	document
domain	n	6	domain
domestic	j	4	domestic
domestically	b	4	domestic
domesticate	v	4	domestic
domestics	n	4	domestic
dominance	n	3	dominate
dominant	j	3	dominate
dominate	v	3	dominate
domination	n	3	dominate
draft	nv	5	draft
drama	n	8	drama
dramatic	j	8	drama
dramatically	b	8	drama
dramatist	n	8	drama
dramatization	n	8	drama
dramatize	v	8	drama
duration	n	9	duration
dynamic	j	7	dynamic
dynamically	b	7	dynamic
dynamics	n	7	dynamic
economic	j	1	economy
economical	j	1	economy
economically	b	1	economy
economist	n	1	economy
economy	n	1	economy
edit	nv	6	edit
edition	n	6	edit
editor	n	6	edit
editorial	jn	6	edit
element	n	2	element
eliminate	v	7	eliminate
elimination	n	7	eliminate
emerge	v	4	emerge
emergence	n	4	emerge
emergent	j	4	emerge
emerging	j	4	emerge
emphasis	n	3	emphasis
emphasize	v	3	emphasis
emphatic	j	3	emphasis
emphatically	b	3	emphasis
empirical	j	7	empirical
empirically	b	7	empirical
empiricism	n	7	empirical
enable	v	5	enable
enabling	j	5	enable
encounter	nv	10	encounter
energetic	j	5	energy
energetically	b	5	energy
energy	n	5	energy
enforce	v	5	enforce
enforcement	n	5	enforce
enhance	v	6	enhance
enhancement	n	6	enhance
enormity	n	10	enormous
enormous	j	10	enormous
enormously	b	10	enormous
ensure	v	3	ensure
entity	n	5	entity
environment	n	1	environment
environmental	j	1	environment
environmentalist	n	1	environment
environmentally	b	1	environment
equate	v	2	equate
equation	n	2	equate
equip	v	7	equip
equipment	n	7	equip
equivalence	n	5	equivalent
equivalent	jn	5	equivalent
erode	v	9	erode
erosion	n	9	erode
erroneous	j	4	error
erroneously	b	4	error
error	n	4	error
establish	v	1	establish
established	j	1	establish
establishment	n	1	establish
estate	n	6	estate
estimate	v	1	estimate
estimation	n	1	estimate
ethic	n	9	ethic
ethical	j	9	ethic
ethically	b	9	ethic
ethics	n	9	ethic
ethnic	j	4	ethnic
ethnicity	n	4	ethnic
evaluate	v	2	evaluate
evaluation	n	2	evaluate
evaluative	j	2	evaluate
eventual	j	8	eventual
eventuality	n	8	eventual
eventually	b	8	eventual
evidence	nv	1	evident
evidenced	j	1	evident
evident	j	1	evident
evidential	j	1	evident
evidently	b	1	evident
evolution	n	5	evolve
evolutionary	j	5	evolve
evolutionist	n	5	evolve
evolve	v	5	evolve
exceed	v	6	exceed
exclude	v	3	exclude
exclusion	n	3	exclude
exclusionary	j	3	exclude
exclusionist	jn	3	exclude
exclusive	jn	3	exclude
exclusively	b	3	exclude
exhibit	nv	8	exhibit
exhibition	n	8	exhibit
expand	v	5	expand
expansion	n	5	expand
expansionism	n	5	expand
expansive	j	5	expand
expert	n	6	expert
expertise	n	6	expert
expertly	b	6	expert
explicit	j	6	explicit
explicitly	b	6	explicit
exploit	nv	8	exploit
exploitation	n	8	exploit
export	nv	1	export
exporter	n	1	export
expose	v	5	expose
exposed	j	5	expose
exposure	n	5	expose
external	j	5	external
externality	n	5	external
externalization	n	5	external
externalization	n	5	external
externalize	v	5	external
externally	b	5	external
extract	nv	7	extract
extraction	n	7	extract
facilitate	v	5	facilitate
facilitation	n	5	facilitate
facilitator	n	5	facilitate
facility	n	5	facilitate
factor	nv	1	factor
feature	nv	2	feature
federal	j	6	federal
federation	n	6	federal
fee	n	6	fee
file	nv	7	file
final	jn	2	final
finality	n	2	final
finalize	v	2	final
finally	b	2	final
finals	n	2	final
finance	nv	1	finance
financial	j	1	finance
financially	b	1	finance
financier	n	1	finance
financing	n	1	finance
finite	j	7	finite
flexibility	n	6	flexible
flexible	j	6	flexible
fluctuate	v	8	fluctuate
fluctuation	n	8	fluctuate
focus	nv	2	focus
format	nv	9	format
formula	n	1	formula
formulae	n	1	formula
formulate	v	1	formula
formulation	n	1	formula
forthcoming	j	10	forthcoming
found	v	9	found
foundation	n	7	foundation
founder	n	9	found
founding	n	9	found
framework	n	3	framework
function	nv	1	function
functional	j	1	function
functionally	b	1	function
functioning	j	1	function
fund	nv	3	fund
fundamental	jn	5	fundamental
fundamentally	b	5	fundamental
funder	n	3	fund
funding	n	3	fund
furthermore	b	6	furthermore
gender	n	6	gender
generate	v	5	generate
generation	n	5	generation
global	j	7	globe
globalization	n	7	globe
globally	b	7	globe
globe	n	7	globe
goal	n	4	goal
grade	nv	7	grade
grant	nv	4	grant
guarantee	nv	7	guarantee
guideline	n	8	guideline
hence	b	4	hence
hierarchical	j	7	hierarchy
hierarchy	n	7	hierarchy
highlight	nv	8	highlight
hypothesis	n	4	hypothesis
hypothesize	v	4	hypothesis
hypothetical	j	4	hypothesis
hypothetically	b	4	hypothesis
identical	j	7	identical
identically	b	7	identical
identifiable	j	1	identify
identification	n	1	identify
identify	v	1	identify
identifying	j	1	identify
identity	n	1	identify
ideological	j	7	ideology
ideologically	b	7	ideology
ideology	n	7	ideology
ignorance	n	6	ignorant
ignorant	j	6	ignorant
ignore	v	6	ignorant
illegal	j	1	legal
illegality	n	1	legal
illegally	b	1	legal
illogical	j	5	logic
illogically	b	5	logic
illustrate	v	3	illustrate
illustration	n	3	illustrate
illustrative	j	3	illustrate
image	nv	5	image
imagery	n	5	image
immature	j	9	mature
immaturity	n	9	mature
immigrant	n	3	immigrate
immigrate	v	3	immigrate
immigration	n	3	immigrate
impact	nv	2	impact
implement	nv	4	implement
implementation	n	4	implement
implicate	v	4	implicate
implication	n	4	implicate
implicit	j	8	implicit
implicitly	b	8	implicit
imply	v	3	imply
impose	v	4	impose
imposition	n	4	impose
imprecise	j	5	precise
inaccessible	j	4	access
inaccuracy	n	6	accurate
inaccurate	j	6	accurate
inadequacy	n	4	adequate
inadequate	j	4	adequate
inadequately	b	4	adequate
inappropriacy	n	2	appropriate
inappropriate	j	2	appropriate
inappropriately	b	2	appropriate
incapable	j	6	capable
incapacitate	v	5	capacity
incentive	n	6	incentive
incidence	n	6	incidence
incident	n	6	incidence
incidentally	b	6	incidence
inclination	n	10	incline
incline	nv	10	incline
inclined	j	10	incline
incoherent	j	9	coherent
incoherently	b	9	coherent
income	n	1	income
incompatibility	n	9	compatible
incompatible	j	9	compatible
inconceivable	j	10	conceive
inconceivably	b	10	conceive
inconclusive	j	2	conclude
inconclusively	b	2	conclude
inconsistency	n	1	consist
inconsistent	j	1	consist
inconstancy	n	3	constant
inconstantly	b	3	constant
incorporate	v	6	incorporate
incorporation	n	6	incorporate
indefinite	j	7	definite
indefinitely	b	7	definite
index	nv	6	index
indicate	v	1	indicate
indication	n	1	indicate
indicative	j	1	indicate
indicator	n	1	indicate
indiscrete	j	5	discrete
indiscretion	n	5	discrete
indistinct	j	2	distinct
indistinctly	b	2	distinct
individual	j	1	individual
individualism	n	1	individual
individualist	jn	1	individual
individualistic	j	1	individual
individuality	n	1	individual
individually	b	1	individual
induce	v	8	induce
induction	n	8	induce
inevitability	n	8	inevitable
inevitable	j	8	inevitable
inevitably	b	8	inevitable
infer	v	7	infer
inference	n	7	infer
infinite	j	7	finite
infinitely	b	7	finite
inflexibility	n	6	flexible
inflexible	j	6	flexible
infrastructure	n	8	infrastructure
inherent	j	9	inherent
inherently	b	9	inherent
inhibit	v	6	inhibit
inhibition	n	6	inhibit
initial	j	3	initial
initially	b	3	initial
initiate	nv	6	initiate
initiation	n	6	initiate
initiative	n	6	initiate
initiator	n	6	initiate
injure	v	2	injure
injury	n	2	injure
innovate	v	7	innovate
innovation	n	7	innovate
innovative	j	7	innovate
innovator	n	7	innovate
input	nv	6	input
insecure	j	2	secure
insecurity	n	2	secure
insert	nv	7	insert
insertion	n	7	insert
insight	n	9	insight
insightful	j	9	insight
insignificant	j	1	significant
insignificantly	b	1	significant
inspect	v	8	inspect
inspection	n	8	inspect
inspector	n	8	inspect
instability	n	5	stable
instance	n	3	instance
institute	nv	2	institute
institution	n	2	institute
institutional	j	2	institute
institutionalize	v	2	institute
institutionally	b	2	institute
instruct	v	6	instruct
instruction	n	6	instruct
instructive	j	6	instruct
instructor	n	6	instruct
insufficient	j	3	sufficient
insufficiently	b	3	sufficient
integral	jn	9	integral
integrate	v	4	integrate
integration	n	4	integrate
integrity	n	10	integrity
intelligence	n	6	intelligent
intelligent	j	6	intelligent
intelligently	b	6	intelligent
intense	j	8	intense
intensely	b	8	intense
intenseness	n	8	intense
intensification	n	8	intense
intensify	v	8	intense
intension	n	8	intense
intensity	n	8	intense
intensive	j	8	intense
intensively	b	8	intense
interact	v	3	interact
interaction	n	3	interact
interactive	j	3	interact
interactively	b	3	interact
intermediate	j	9	intermediate
internal	j	4	internal
internalize	v	4	internal
internally	b	4	internal
interpret	v	1	interpret
interpretation	n	1	interpret
interpretative	j	1	interpret
interpretive	j	1	interpret
interval	n	6	interval
intervene	v	7	intervene
intervening	j	7	intervene
intervention	n	7	intervene
intrinsic	j	10	intrinsic
intrinsically	b	10	intrinsic
invalidate	v	3	valid
invalidity	n	3	valid
invariable	j	1	vary
invariably	b	1	vary
invest	v	2	invest
invested	j	2	invest
investigate	v	4	investigate
investigation	n	4	investigate
investigative	j	4	investigate
investigator	n	4	investigate
investment	n	2	invest
investor	n	2	invest
invisibility	n	7	visible
invisible	j	7	visible
invoke	v	10	invoke
involve	v	1	involve
involved	j	1	involve
involvement	n	1	involve
irrational	j	6	rational
irrelevance	n	2	relevant
irrelevant	j	2	relevant
irreversible	j	7	reverse
isolate	jv	7	isolate
isolating	j	7	isolate
isolation	n	7	isolate
isolationism	n	7	isolate
issue	nv	1	issue
item	n	2	item
itemization	n	2	item
itemize	v	2	item
job	n	4	job
journal	nv	2	journal
justifiable	j	3	justify
justifiably	b	3	justify
justification	n	3	justify
justified	j	3	justify
justify	v	3	justify
label	nv	4	label
labor	nv	1	labour
labored	j	1	labour
layer	nv	3	layer
lecture	nv	6	lecture
lecturer	n	6	lecture
legal	j	1	legal
legality	n	1	legal
legally	b	1	legal
legislate	v	1	legislate
legislation	n	1	legislate
legislative	j	1	legislate
legislator	j	1	legislate
legislature	n	1	legislate
levy	nv	10	levy
liberal	j	5	liberal
liberalism	n	5	liberal
liberalization	n	5	liberal
liberalize	v	5	liberal
liberally	b	5	liberal
liberate	v	5	liberal
liberation	n	5	liberal
liberator	n	5	liberal
license	nv	5	license
license	nv	5	license
likewise	b	10	likewise
link	nv	3	link
linkage	n	3	link
locate	v	3	locate
location	n	3	locate
logic	n	5	logic
logical	j	5	logic
logically	b	5	logic
logician	n	5	logic
maintain	v	2	maintain
maintenance	n	2	maintain
major	jnv	1	major
majority	n	1	major
manipulate	v	8	manipulate
manipulation	n	8	manipulate
manipulative	j	8	manipulate
manual	jn	9	manual
manually	b	9	manual
margin	n	5	margin
marginal	j	5	margin
marginally	b	5	margin
maturation	n	9	mature
maturational	j	9	mature
mature	jv	9	mature
maturity	n	9	mature
max	j	3	maximize
maximization	n	3	maximize
maximize	v	3	maximize
maximum	jn	3	maximize
mechanism	n	4	mechanism
media	n	7	media
mediate	v	9	mediate
mediation	n	9	mediate
medical	jn	5	medical
medically	b	5	medical
medium	jn	9	medium
mental	j	5	mental
mentality	n	5	mental
mentally	b	5	mental
method	n	1	method
methodical	j	1	method
methodological	j	1	method
methodology	n	1	method
migrant	n	6	migrate
migrate	v	6	migrate
migration	n	6	migrate
migratory	j	6	migrate
military	n	9	military
minimal	j	9	minimal
minimalist	n	9	minimal
minimalistic	j	9	minimal
minimalization	n	9	minimal
minimalize	v	9	minimal
minimally	b	9	minimal
minimize	v	8	minimize
minimum	jn	6	minimum
minister	nv	6	ministry
ministerial	j	6	ministry
ministering	j	6	ministry
ministry	n	6	ministry
minor	jn	3	minor
minority	n	3	minor
misinterpret	v	1	interpret
misinterpretation	n	1	interpret
mode	n	7	mode
modification	n	5	modify
modify	v	5	modify
monitor	nv	5	monitor
motivate	v	6	motive
motivating	j	6	motive
motivation	n	6	motive
motive	n	6	motive
multidimensional	j	4	dimension
mutual	j	9	mutual
mutually	b	9	mutual
negate	v	3	negate
negative	jn	3	negate
negatively	b	3	negate
network	nv	5	network
neutral	j	6	neutral
neutrality	n	6	neutral
neutralization	n	6	neutral
neutralize	v	6	neutral
nevertheless	b	6	nevertheless
non-conformist	n	8	conform
non-conformity	n	8	conform
non-traditional	j	2	tradition
nonconformist	n	8	conform
nonconformity	n	8	conform
nonetheless	b	10	nonetheless
norm	n	9	norm
normal	j	2	normal
normality	n	2	normal
normalization	n	2	normal
normalize	v	2	normal
normally	b	2	normal
notion	n	5	notion
notwithstanding	bp	10	notwithstanding
nuclear	j	8	nuclear
objective	n	5	objective
objectively	b	5	objective
objectivity	n	5	objective
obtain	v	2	obtain
obtainable	j	2	obtain
obvious	j	4	obvious
obviously	b	4	obvious
occupancy	n	4	occupy
occupant	n	4	occupy
occupation	n	4	occupy
occupational	j	4	occupy
occupier	n	4	occupy
occupy	v	4	occupy
occur	v	1	occur
occurrence	n	1	occur
odd	j	10	odd
odds	n	10	odd
offset	nv	8	offset
ongoing	j	10	ongoing
option	n	4	option
optional	j	4	option
orient	nv	5	orient
orientate	v	5	orient
orientation	n	5	orient
outcome	n	3	outcome
output	nv	4	output
over-estimate	v	1	estimate
overall	j	4	overall
overestimate	v	1	estimate
overlap	nv	9	overlap
overseas	b	6	overseas
panel	nv	10	panel
paradigm	n	7	paradigm
paragraph	nv	8	paragraph
parallel	jn	4	parallel
parameter	n	4	parameter
participant	n	2	participate
participate	v	2	participate
participation	n	2	participate
participatory	j	2	participate
partner	nv	3	partner
partnership	n	3	partner
passive	j	9	passive
passively	b	9	passive
passivity	n	9	passive
perceive	v	2	perceive
percent	n	1	percent
percentage	n	1	percent
perception	n	2	perceive
period	n	1	period
periodic	j	1	period
periodical	jn	1	period
periodically	b	1	period
persist	v	10	persist
persistence	n	10	persist
persistent	j	10	persist
persistently	b	10	persist
perspective	n	5	perspective
phase	nv	4	phase
phenomenal	j	7	phenomenon
phenomenon	n	7	phenomenon
philosopher	n	3	philosophy
philosophical	j	3	philosophy
philosophically	b	3	philosophy
philosophize	v	3	philosophy
philosophy	n	3	philosophy
physical	j	3	physical
physically	b	3	physical
plus	nv	8	plus
policy	n	1	policy
portion	nv	9	portion
pose	nv	10	pose
positive	j	2	positive
positively	b	2	positive
potential	jn	2	potential
potentially	b	2	potential
practitioner	n	8	practitioner
precede	v	6	precede
precedence	n	6	precede
precedent	n	6	precede
precise	j	5	precise
precision	n	5	precise
predict	v	4	predict
predictability	n	4	predict
predictable	j	4	predict
predictably	b	4	predict
prediction	n	4	predict
predominance	n	8	predominant
predominant	j	8	predominant
predominantly	b	8	predominant
predominate	v	8	predominant
preliminary	jn	9	preliminary
presumably	b	6	presume
presume	v	6	presume
presumption	n	6	presume
presumptuous	j	6	presume
previous	j	2	previous
previously	b	2	previous
primacy	n	5	prime
primarily	b	2	primary
primary	j	2	primary
prime	jnv	5	prime
principal	j	4	principal
principally	b	4	principal
principle	jn	1	principle
principled	j	1	principle
prior	j	4	prior
prioritization	n	7	priority
prioritize	v	7	priority
priority	n	7	priority
procedural	j	1	proceed
procedure	n	1	proceed
proceed	v	1	proceed
proceedings	n	1	proceed
process	nv	1	process
professional	j	4	professional
professionalism	n	4	professional
professionally	b	4	professional
prohibit	v	7	prohibit
prohibition	n	7	prohibit
prohibitive	j	7	prohibit
project	nv	4	project
projection	n	4	project
promote	v	4	promote
promoter	n	4	promote
promotion	n	4	promote
proportion	n	3	proportion
proportional	j	3	proportion
proportionally	b	3	proportion
proportionate	j	3	proportion
proportionately	b	3	proportion
prospect	nv	8	prospect
prospective	j	8	prospect
protocol	n	9	protocol
psychological	j	5	psychology
psychologically	b	5	psychology
psychologist	n	5	psychology
psychology	n	5	psychology
publication	n	7	publication
publish	v	3	publish
publisher	n	3	publish
publishing	n	3	publish
purchase	nv	2	purchase
purchaser	n	2	purchase
pursue	v	5	pursue
pursuit	n	5	pursue
qualitative	j	9	qualitative
qualitatively	b	9	qualitative
quotation	n	7	quote
quote	nv	7	quote
radical	jn	8	radical
radically	b	8	radical
random	j	8	random
randomly	b	8	random
randomness	n	8	random
range	nv	2	range
ratio	n	5	ratio
rational	j	6	rational
rationalism	n	6	rational
rationality	n	6	rational
rationalization	n	6	rational
rationalize	v	6	rational
rationally	b	6	rational
re-evaluate	n	2	evaluate
re-evaluation	n	2	evaluate
react	v	3	react
reaction	n	3	react
reactionary	n	3	react
reactivate	v	3	react
reactivation	n	3	react
reactive	j	3	react
reactor	n	3	react
readjust	v	5	adjust
readjustment	n	5	adjust
reassess	v	1	assess
reassessment	n	1	assess
reassign	v	6	assign
recommence	v	9	commence
reconstruct	v	2	construct
reconstruction	n	2	construct
recover	v	6	recover
recoverable	j	6	recover
recovery	n	6	recover
recreate	v	1	create
redefine	v	1	define
redistribute	v	1	distribute
redistribution	n	1	distribute
redraft	v	5	draft
refine	v	9	refine
refined	j	9	refine
refinement	n	9	refine
refocus	nv	2	focus
reformulate	v	1	formula
reformulation	n	1	formula
regime	n	4	regime
region	n	2	region
regional	j	2	region
regionally	b	2	region
register	nv	3	register
registration	n	3	register
regulate	v	2	regulate
regulation	n	2	regulate
regulator	n	2	regulate
regulatory	j	2	regulate
reinforce	v	8	reinforce
reinforcement	n	8	reinforce
reinterpret	v	1	interpret
reinterpretation	n	1	interpret
reinvest	v	2	invest
reinvestment	n	2	invest
reject	nv	5	reject
rejection	n	5	reject
relax	v	9	relax
relaxation	n	9	relax
release	nv	7	release
relevance	n	2	relevant
relevant	j	2	relevant
reliability	n	3	rely
reliable	j	3	rely
reliably	b	3	rely
reliance	n	3	rely
reliant	j	3	rely
relocate	v	3	locate
relocation	n	3	locate
reluctance	n	10	reluctance
reluctant	j	10	reluctance
reluctantly	b	10	reluctance
rely	v	3	rely
removable	j	3	remove
removal	n	3	remove
remove	v	3	remove
reoccur	v	1	occur
reorient	v	5	orient
reorientation	n	5	orient
require	v	1	require
requirement	n	1	require
reschedule	v	8	schedule
research	nv	1	research
researcher	n	1	research
reside	v	2	reside
residence	n	2	reside
resident	n	2	reside
residential	j	2	reside
resolution	n	4	resolve
resolve	v	4	resolve
resource	nv	2	resource
resourceful	j	2	resource
respond	v	1	respond
respondent	n	1	respond
response	n	1	respond
responsive	j	1	respond
responsiveness	n	1	respond
restoration	n	8	restore
restore	v	8	restore
restrain	v	9	restrain
restraint	n	9	restrain
restrict	v	2	restrict
restriction	n	2	restrict
restrictive	j	2	restrict
restrictively	b	2	restrict
restructure	v	1	structure
restructuring	n	1	structure
retain	v	4	retain
retainer	n	4	retain
retention	n	4	retain
retentive	j	4	retain
reveal	v	6	reveal
revealing	j	6	reveal
revelation	n	6	reveal
revenue	n	5	revenue
reversal	n	7	reverse
reverse	nv	7	reverse
reversible	j	7	reverse
revise	v	8	revise
revision	n	8	revise
revolution	n	9	revolution
revolutionary	jn	9	revolution
revolutionist	n	9	revolution
revolutionize	v	9	revolution
rigid	j	9	rigid
rigidity	n	9	rigid
rigidly	b	9	rigid
role	n	1	role
route	nv	9	route
scenario	n	9	scenario
schedule	nv	8	schedule
schematic	j	3	scheme
schematically	b	3	scheme
scheme	nv	3	scheme
scheming	j	3	scheme
scope	nv	6	scope
section	nv	1	section
sector	n	1	sector
secure	jv	2	secure
securely	b	2	secure
security	n	2	secure
seek	n	2	seek
select	jv	2	select
selection	n	2	select
selective	j	2	select
selectively	b	2	select
selector	n	2	select
sequence	nv	3	sequence
sequential	j	3	sequence
sequentially	b	3	sequence
series	n	4	series
sex	n	3	sex
sexism	n	3	sex
sexual	j	3	sex
sexuality	n	3	sex
sexually	b	3	sex
shift	nv	3	shift
shifting	j	3	shift
significance	n	1	significant
significant	j	1	significant
significantly	b	1	significant
signify	v	1	significant
similar	j	1	similar
similarity	n	1	similar
similarly	b	1	similar
simulate	v	7	simulate
simulation	n	7	simulate
site	nv	2	site
so-called	j	10	so-called
sole	j	7	sole
solely	b	7	sole
somewhat	b	7	somewhat
source	nv	1	source
specifiable	j	3	specify
specific	j	1	specific
specifically	b	1	specific
specification	n	1	specific
specificity	n	1	specific
specifics	n	1	specific
specify	v	3	specify
sphere	n	9	sphere
spherical	j	9	sphere
spherically	b	9	sphere
stability	n	5	stable
stabilization	n	5	stable
stabilize	v	5	stable
stable	j	5	stable
statistic	n	4	statistic
statistical	j	4	statistic
statistically	b	4	statistic
statistician	n	4	statistic
statistics	n	4	statistic
status	n	4	status
straightforward	j	10	straightforward
strategic	j	2	strategy
strategically	b	2	strategy
strategist	n	2	strategy
strategy	n	2	strategy
stress	nv	4	stress
stressful	j	4	stress
structural	j	1	structure
structurally	b	1	structure
structure	nv	1	structure
style	nv	5	style
stylish	j	5	style
stylize	v	5	style
submission	n	7	submit
submit	v	7	submit
subordinate	jnv	9	subordinate
subordination	n	9	subordinate
subsequent	j	4	subsequent
subsequently	b	4	subsequent
subsidiary	n	6	subsidy
subsidize	v	6	subsidy
subsidy	n	6	subsidy
substitute	nv	5	substitute
substitution	n	5	substitute
succession	n	7	successor
successive	j	7	successor
successively	b	7	successor
successor	n	7	successor
sufficiency	n	3	sufficient
sufficient	j	3	sufficient
sufficiently	b	3	sufficient
sum	nv	4	sum
summarization	n	4	summary
summarize	v	4	summary
summary	n	4	summary
summation	n	4	sum
supplement	nv	9	supplement
supplementary	j	9	supplement
survey	nv	2	survey
survival	n	7	survive
survive	v	7	survive
survivor	n	7	survive
suspend	v	9	suspend
suspension	n	9	suspend
sustain	v	5	sustain
sustainability	n	5	sustain
sustainable	j	5	sustain
sustenance	n	5	sustain
symbol	n	5	symbol
symbolic	j	5	symbol
symbolically	b	5	symbol
symbolism	n	5	symbol
symbolize	v	5	symbol
tape	nv	6	tape
target	nv	5	target
task	nv	3	task
team	nv	9	team
technical	j	3	technical
technically	b	3	technical
technique	n	3	technique
technological	j	3	technology
technologically	b	3	technology
technology	n	3	technology
temporarily	b	9	temporary
temporary	j	9	temporary
tense	jnv	8	tense
tensely	b	8	tense
tension	n	8	tense
terminal	jn	8	terminate
terminate	v	8	terminate
termination	n	8	terminate
text	nv	2	text
textual	j	2	text
thematic	j	8	theme
thematically	b	8	theme
theme	nv	8	theme
theoretical	j	1	theory
theoretically	b	1	theory
theorist	n	1	theory
theory	n	1	theory
thereby	b	8	thereby
thesis	n	7	thesis
topic	n	7	topic
topical	j	7	topic
trace	nv	6	trace
traceable	j	6	trace
tradition	n	2	tradition
traditional	j	2	tradition
traditionalist	n	2	tradition
traditionally	b	2	tradition
transfer	nv	2	transfer
transferable	j	2	transfer
transference	n	2	transfer
transform	v	6	transform
transformation	n	6	transform
transit	nv	5	transit
transition	n	5	transit
transitional	j	5	transit
transitory	j	5	transit
transmission	n	7	transmit
transmit	v	7	transmit
transport	nv	6	transport
transportation	n	6	transport
transporter	n	6	transport
trend	nv	5	trend
trigger	nv	9	trigger
ultimate	j	7	ultimate
ultimately	b	7	ultimate
unaccompanied	j	8	accompany
unaffected	j	2	affect
unaided	j	7	aid
unalterable	j	5	alter
unaltered	j	5	alter
unambiguous	j	8	ambiguous
unambiguously	b	8	ambiguous
unanticipated	j	9	anticipate
unappreciated	j	8	appreciate
unapproachable	j	1	approach
unassessed	j	1	assess
unassigned	j	6	assign
unassisted	j	2	assist
unattached	j	6	attach
unattainable	j	9	attain
unavailable	j	1	available
unaware	j	5	aware
unbiased	j	8	bias
uncharted	j	8	chart
uncommunicative	j	4	communicate
unconfined	j	9	confine
unconstitutional	j	1	constitute
unconstrained	j	3	constrain
uncontextualized	j	1	context
uncontroversial	j	9	controversy
unconventional	j	3	convene
unconvinced	j	10	convince
uncultured	j	2	culture
undefined	j	1	define
undeniable	j	7	deny
under-resourced	j	2	resource
underestimate	v	1	estimate
undergo	v	10	undergo
underlie	v	6	underlie
undertake	v	4	undertake
undertaking	n	4	undertake
undiminished	j	9	diminish
uneconomical	j	1	economy
unethical	j	9	ethic
unfounded	j	9	found
unidentifiable	j	1	identify
unification	n	9	unify
uniform	jn	8	uniform
uniformity	n	8	uniform
uniformly	b	8	uniform
unify	v	9	unify
uninjured	j	2	injure
unintelligent	j	6	intelligent
uninvolved	j	1	involve
unique	j	7	unique
uniquely	b	7	unique
uniqueness	n	7	unique
unjustified	j	3	justify
unlicensed	j	5	license
unmodified	j	5	modify
unmonitored	j	5	monitor
unmotivated	j	6	motive
unobtainable	j	2	obtain
unparalleled	j	4	parallel
unprecedented	j	6	precede
unpredictability	n	4	predict
unpredictable	j	4	predict
unprincipled	j	1	principle
unpublished	j	3	publish
unregulated	j	2	regulate
unreliable	j	3	rely
unresolved	j	4	resolve
unresourceful	j	2	resource
unresponsive	j	1	respond
unrestrained	j	9	restrain
unrestricted	j	2	restrict
unrestrictive	j	2	restrict
unscheduled	j	8	schedule
unspecified	j	3	specify
unstable	j	5	stable
unstressed	j	4	stress
unstructured	j	1	structure
unsustainable	j	5	sustain
utility	n	6	utilize
utilization	n	6	utilize
utilize	v	6	utilize
utilize	v	6	utilize
utilizer	n	6	utilize
valid	j	3	valid
validate	v	3	valid
validating	j	3	valid
validation	n	3	valid
validity	n	3	valid
validly	b	3	valid
variability	n	1	vary
variable	j	1	vary
variably	b	1	vary
variance	n	1	vary
variant	n	1	vary
variation	n	1	vary
varied	j	1	vary
vary	v	1	vary
vehicle	n	8	vehicle
version	n	5	version
via	p	8	via
violate	v	9	violate
violation	n	9	violate
virtual	j	8	virtual
virtually	b	8	virtual
visibility	n	7	visible
visible	j	7	visible
visibly	b	7	visible
vision	n	9	vision
visual	j	8	visual
visualization	n	8	visual
visualize	v	8	visual
visually	b	8	visual
volume	n	3	volume
voluntarily	b	7	voluntary
voluntary	j	7	voluntary
volunteer	nv	7	voluntary
welfare	n	5	welfare
whereas	c	5	whereas
whereby	b	10	whereby
widespread	j	8	widespread
